2220000000000000000000
1100000000000000000000
0000000000000003000000
0000000000000000000000
0000300022000000000000
2000000011222000000300
1200000011111000000000
1122000000000000000000
1111200000030000000000
1111122222222220022222
1111111111111100001111
1111111111111100001111
1111111111111103001111
1111111111111111111111