0000000003333000000000000000000000000000000000000000000000000000000000000000000000000000000000000000000000000000000000000000000003333
0000000003333000000000000000000000000000000000000000000000000000000000000000000000000000000000000000000000000000000000000000000003333
0000000003333000000000000000000000000000000000000000000000000000000000000000000000000000000000000000000000000000000000000000000003333
0000000003333000000000000000000000000000000000000000000000000000000000000000000000000000000000000000000000000000000000000000000003333
0000000003333000000000000000000000000000000000000000000000000000000000000000000000000000000000000000000000000000000000000000000003333
0000000003333000000000000000000000000000000000000000000000000000000000000000000000000000000000000000000000000000000000000000000003333
0000000003333000000000000000000000000000000000000000000000000000000000000000000000000000000000000000000000000000000000000000000003333
0000000003333000000000000000000000000000000000000000000000000000000000000000000000000000000000000000003333333333300000000000000003333
0000000003333000000000000000000000000000000000000000000000000000000000000000000000000000000000000000003000000000000000000000000003333
0000000003333000000000000000000000000000000000000000000000000000000000000000000000000000000000000000003000000000000000000000000003333
0000000003333000000000000000000000000000000000000000000000000000000000000000000000000000000000000000003000000000000000000000000003333
00000000033330000000000000000000000000000000000000000000000000000000000000000000000000000000000000000030c0000h000c0000000000000003333
0000000003333000000000000222000000000000000000000000000000000000000000000000000000000000000000000000003000000000000000000000000003333
0000000003333000000000000111222200000000000000000000000000000000000000000000000000000000000000000000003000005000000000000000000003333
0000000003333000000000002111111100000000000000000000000000000000000000000000000000000000000000000000003333333333333300000000000003333
0000000003333000000000021000111100000000000000000000000000000000000000000000000000000000000000000000000000000000000000000000000003333
0000000003333000060000210000000000000000000000000000000000000000000000000000000000000000000000000000000000000000000000000000000003333
0000000003333000000002100000600000000000000000000000000000000000002222000000000000000000000000000000000000000000000000333000000003333
0000000003333000000221500000000022000000000000000000000000000222221110000000000000000000000000000000000000000000000000000000000003333
0000000003333000002111111400041111200000000000222222000000222111111000000000000000300000000000000000000000000000000000000000000003333
0000000003333000021111144400044411122222000222111111225002111111110000000000000000000000600000000000000000000000000000000000000003333
000000000444400000000000000000004441111122211111111111222111111111h000300022050000000000000000000000000000000000000000000033300004444
0000000004444000000000000000000000000111111111111111111111111111112c00000011222000000300000000000000000000000000000000000000000004444
0000000004444050000000600000000000000004111111444444441114444444111200000011111000000000000000000000000000000000000000000000000004444
0000000004444444400000000000000000000000444444444444444444444444411122000000000000000000000010000000005000000006000000000000050004444
0000000004444444400000000050000000000000444444444444444444444444411111200000030000000500222c36000000000000000000000000000000000224444
0000000004444004400000000000000000000004444444444444444444444444411111122222222220022222111333000000000000000000000000000000000114444
0000000004444004444444444444440000000044000044444444444444444444411111111111111100001111111132220000000000005000000005000000022114444
0000000004444000444444444444444000000044000000444444444444444444411111111111111100000000000011112200000000000000000000000002211114444
0000000004444000000000000000000000000040000000004444444444444444444444444444444453005000000000001122200000000000000222222221111114444
0000000004444000000060000000000000000040000000000444444444444444444444444444444444444444000000000001122222222222222111111111111114444
0000000004444060000000000000000000000440000000000444444444444444440000600000000000000000000000000000011111111111111111111111111114444
0000000004444000000500000000004444444440060000000444444444444444440000000000000050000000000000000500000000000000000000000000000004444
0000000004444000000000000000444400000000000000000444444444444444440005000044444440000000000000000000000000000000000000000000000004444
0000000004444000000000444444440006000000000000050444444444444444444444444444444444444444444440000000000444444444444444440000004444444
0000000004444000000000444444400000h0000000000400c444444444444444444444444444444444444444444444444444444444444440000000440000044444444
0000000004444c00000000000000000000000000000044444444444444444444444440000000000000000000000000000000000000000000000000000000044444444
0000000004444400000000000500000000000000004444444444444444444444444400000000000000000000000000000000000000000000000000000000044444444
0000000004444444444444444444444444444444444444444444444444444444444000000000000000000000000000000000000000000000000000000000444444444
0000000004444444444444444444444444444444444444444444444444444444440000000000000000000000000000000000000000050000000000000000444444444
0000000004444444444444444444444444444444444444444444444444444444440000000000005000005000000000000000000000000000000000000004444444444
0000000004444444444444444444444444444444444444400000000000000444440000000000000000000000000000000000000000000000000000000044444444444
0000000004444444444400000000000000000000000000000000000000000000040000000000000000000000000000000000004400000000000000000044444444444
0000000004444000000000000060000000000000000000000000000000000000044000000000000000000000000000000004444440000000000000000044444444444
0000000004444000000000000000000000000000000000000000000000000000044000000000444444444444444444444444444444444444400004444444444444444
000000000444400000005000c000000h00000000000000060000000000000000000000000004444400004440000004444444444400444444444444444444444444444
0000000004444000000000000000000000000000000050000000000000000000000000000000000000000000000000000000000000000000000004000440440444444
0000000004444000000000033333333333300000000000000000000000000000000000500000000000000000000000000000000000000000000000000000000004444
0000000004444000050000000000000000000000000000000000000000050000000000000000000000000000000000500000000000000500000000000000000004444
0000000004444000000000000000000000000000000000004444400000000000000000000040000000000000500000000000000000000000000000c00000000004444
0000000004444000000000000000000000000000000000444444444440000000000000000040000000000000000000050000000000000000000000000000000004444
000000000444444444000000000000000044444444444444444444444444444444444444444444000000000000c000000000000000000000000000044444444444444
0000000004444444444444444444444444444444444444444444444444444444444444444444444444444000000000000000000000004444444444444444444444444
0000000004444444444444444444444444444444444444444444444444444444444444444444444444444444444444444444444444444444444444444444444444444
0000000004444444444444444444444444444444444444444444444444444444444444444444444444444444444444444444444444444444444444444444444444444
0000000000000000000000000000000000000000000000000000000000000000000000000000000000000000000000000000000000000000000000000000000000000
0000000000000000000000000000000000000000000000000000000000000000000000000000000000000000000000000000000000000000000000000000000000000
0000000000000000000000000000000000000000000000000000000000000000000000000000000000000000000000000000000000000000000000000000000000000
0000000000000000000000000000000000000000000000000000000000000000000000000000000000000000000000000000000000000000000000000000000000000
