3000000000000000000000000000000000000000000000000000000000000000000000000000000000000000003333333333300000000000000003
3000000000000000000000000000000000000000000000000000000000000000000000000000000000000000003000000000000000000000000003
3000000000000000000000000000000000000000000000000000000000000000000000000000000000000000003000000000000000000000000003
3000000000000000000000000000000000000000000000000000000000000000000000000000000000000000003000000000000000000000000003
3000000000000000000000000000000000000000000000000000000000000000000000000000000000000000003000000000000000000000000003
3000000000000222000000000000000000000000000000000000000000000000000000000000000000000000003000000000000000000000000003
3000000000000111222200000000000000000000000000000000000000000000000000000000000000000000003000000000000000000000000003
3000000000002111111100000000000000000000000000000000000000000000000000000000000000000000003333333333333300000000000003
3000000000021000111100000000000000000000000000000000000000000000000000000000000000000000000000000000000000000000000003
3000000000210000000000000000000000000000000000000000000000000000000000000000000000000000000000000000000000000000000003
3000000002100000000000000000000000000000000000000000002222000000000000000000000000000000000000000000000000333000000003
3000000221500000000022000000000000000000000000000222221110000000000000000000000000000000000000000000000000000000000003
3000002111111400041111200000000000222222000000222111111000000000000000300000000000000000000000000000000000000000000003
3000021111144400044411122222000222111111225002111111110000000000000000000000600000000000000000000000000000000000000003
400000000000000000004441111122211111111111222111111111h000300022050000000000000000000000000000000000000000000033300003
4000000000000000000000000111111111111111111111111111112c00000011222000000300000000000000000000000000000000000000000003
4050000000600000000000000004444444444444441114444444111200000011111000000000000000000000000000000000000000000000000003
4444400000000000000000000000444444444444444444444444411122000000000000000000000010000000000000000000000000000000000003
4444400000000050000000000000444444444444444444444444411111200500030000000500000c36000000000000000000000000000000000223
4004400000000000000000000004444444444444444444444444411111122222222220022222000333000000000000000000000000000000000113
4004444444444444440000000044000044444444444444444000011111111111111100001111000032220000000000000000000000000000022113
4000444444444444444000000044000000444444444444444000011111111111111100000000000000012200000000000000000000000002210003
4000000000000000000000000040000000004444444444444000044444444444444453505050000000000122200000000000000222222221000003
4000000060000000000000000040000000000444444444444000044444444444444444444444000000000000122222222222222100000000000003
4060000000000000000000000440000000000444444444444000040000000000000000000000000000000000000000000000000000000000000003
4000000500000000004444444440060000000444444444444000040000000000000000000000000000000000000000000000000000000000000003
4000000000000000444400000000000000000444444444444000040000000044444440000000000000000000000000000000000000000000000003
4000000000444444440006000000000000050444444444444000044444444444444444444444444440000000000444444444444400000000044443
4000000000444444400000h00000000004000444444444444000040000000000000060000000000044444444444400000000000000000000000003
4c00000000000000000000000000000044444444444444444000040000000000000000000000000000000000000000000000000000000000000003
4400000000000500000000000000004444444444444444444000040000000000000000000000000000000000000000000000000000000000000003
444444444444444444444444444444444444444444444444400004000000004000000100000005c505050000000000000000000000000000000003
4444444444444444444444444444444444444444444444444000040100000044000001100001111111111000000000000000000000000000000003
4444444444444444444444444444444444444444444444444000000000000000000000000000000000000000000000000000000000000000000003
4000000000000000000000000000000000000000000000000000000000000000000000000000000000000000000000000000000000000000000003
4000000000000000000000000000000000000000000000000000000100500000000000000000000000000000000000000000000000000000000003
4000000000000000000000000000000000000000000000000000000010000000000000000000000000600000000000000000000000000000000003
4000000000000000000000000000000000000000000000000000000001000000006000000000000000000000000000000000000000000000000003
4000000000000000000000000000000000000000000000000000000000100000000000010000000000000000000000000000001111000000000003
4000000000000000000000000000000000000000000000000000000000010000000000000000000011100000000000000000000000000000000003
4000000000000000000000000000000000000000000000000000000000001000000000000000000000000000000000100000000000000000000003
4000000000000000000000000000000000000000000000000000000000000100000000001100000000000000000000000000000000000000000003
4000000000000000000000000000000000000000000000000000000000000000000000000000000000000000000000000000000000000000000003
4000000000000000000000000000000000000000000000000000000000000001111100000000000010000000000111000000000000000000000003
4000000000000000000000000000000000000000000000000000000000000000000000000000000000000100000000000000000000000000000003
4000000000000000000000000000000000000000000000000000000000000000000000000000000100000000000000000000000000000000000003
4000000000000000000000000000000000000000000000000000000000000000000000000000000000000000000000000000000000000000000003
4000000000000000000000000000000000000000000000000000000000000000000000001110000000000000000000000000000000000000000003
4000000000000000000000000000000000000000000000000000000000000000000000000000000000000000000000000000000000000000000003
4000000000000000000000000000000000000000000000000000000000000000000000000000000000000000000000000000000000000000000003
4000000000000000000000000000000000000000000000000000000000000000000000000000000000000000000000000000000000000000000003
4000000000000000000000000000000000000000000000000000000000000000000000000000000000000000000000000000000000000000000003