33333333333330000000000000000000000000000000000000000000000000000000000000000000000000000000000000000000000000000000000000000000033333333333
33333333333330000000000000000000000000000000000000000000000000000000000000000000000000000000000000000000000000000000000000000000033333333333
33333333333330000000000000000000000000000000000000000000000000000000000000000000000000000000000000000000000000000000000000000000033333333333
33333333333330000000000000000000000000000000000000000000000000000000000000000000000000000000000000000000000000000000000000000000033333333333
33333333333330000000000000000000000000000000000000000000000000000000000000000000000000000000000000000000000000000000000000000000033333333333
33333333333330000000000000000000000000000000000000000000000000000000000000000000000000000000000000000000000000000000000000000000033333333333
33333333333330000000000000000000000000000000000000000000000000000000000000000000000000000000000000000000000000000000000000000000033333333333
33333333333330000000000000000000000000000000000000000000000000000000000000000000000000000000000000000033333333333000000000000000033333333333
33333333333330000000000000000000000000000000000000000000000000000000000000000000000000000000000000000030000000000000000000000000033333333333
33333333333330000000000000000000000000000000000000000000000000000000000000000000000000000000000000000030000000000000000000000000033333333333
33333333333330000000000000000000000000000000000000000000000000000000000000000000000000000000000000000030000000000000000000000000033333333333
33333333333330000000000000000000000000000000000000000000000000000000000000000000000000000000000000000030000000000000000000000000033333333333
33333333333330000000000002220000000000000000000000000000000000000000000000000000000000000000000000000030000000000000000000000000033333333333
33333333333330000000000001112222000000000000000000000000000000000000000000000000000000000000000000000030000000000000000000000000033333333333
33333333333330000000000021111111000000000000000000000000000000000000000000000000000000000000000000000033333333333333000000000000033333333333
33333333333330000000000210001111000000000000000000000000000000000000000000000000000000000000000000000000000000000000000000000000033333333333
33333333333330000600002100000000000000000000000000000000000000000000000000000000000000000000000000000000000000000000000000000000033333333333
33333333333330000000021000006000000000000000000000000000000000000022220000000000000000000000000000000000000000000000003330000000033333333333
33333333333330000002215000000000220000000000000000000000000002222211100000000000000000000000000000000000000000000000000000000000033333333333
33333333333330000021111114000411112000000000002222220000002221111110000000000000003000000000000000000000000000000000000000000000033333333333
33333333333330000211111444000444111222220002221111112250021111111100000000000000000000006000000000000000000000000000000000000000033333333333
444444444444400000000000000000004441111122211111111111222111111111h0003000220500000000000000000000000000000000000000000000333000044444444444
4444444444444000000000000000000000000111111111111111111111111111112c000000112220000003000000000000000000000000000000000000000000044444444444
44444444444440500000006000000000000000041111114444444411144444441112000000111110000000000000000000000000000000000000000000000000044444444444
44444444444444444000000000000000000000004444444444444444444444444111220000000000000000000000100000000000000000060000000000000000044444444444
4444444444444444400000000050000000000000444444444444444444444444411111200000030000000500222c360000000000000000000000000000000002244444444444
44444444444440044000000000000000000000044444444444444444444444444111111222222222200222221113330000000000000000000000000000000001144444444444
44444444444440044444444444444400000000440000444444444444444444444111111111111111000011111111322200000000000050000000050000000221144444444444
44444444444440004444444444444440000000440000004444444444444444444111111111111111000000000000111122000000000000000000000000022111144444444444
44444444444440000000000000000000000000400000000044444444444444444444444444444444530050000000000011222000000000000002222222211111144444444444
44444444444440000000600000000000000000400000000004444444444444444444444444444444444444440000000000011222222222222221111111111111144444444444
44444444444440600000000000000000000004400000000004444444444444444400000000000000000000000000000000000111111111111111111111111111144444444444
44444444444440000005000000000044444444400600000004444444444444444400000000000000500000000000000005000000000000000000000000000000044444444444
44444444444440000000000000004444000000000000000004444444444444444400000000444444400000000000000000000000000000000000000000000000044444444444
44444444444440000000004444444400060000000000000504444444444444444444444444444444444444444444400000000004444444444444444400000044444444444444
4444444444444000000000444444400000h000000000040004444444444444444444444444444444444444444444444444444444444444400000004400000444444444444444
4444444444444c000000000000000000000000000000444444444444444444444444400000000000000000000000000000000000000000000000000000000444444444444444
44444444444444000000000005000000000000000044444444444444444444444444000000000000000000000000000000000000000000000000000000000444444444444444
44444444444444444444444444444444444444444444444444444444444444444440000000000000000000000000000000000000000000000000000000004444444444444444
44444444444444444444444444444444444444444444444444444444444444444400000000000000000000000000000000000000000500000000000000004444444444444444
44444444444444444444444444444444444444444444444444444444444444444400000000000050000050000000000000000000000000000000000000044444444444444444
44444444444444444444444444444444444444444444444000000000000004444400000000000000000000000000000000000000000000000000000000444444444444444444
44444444444444444444000000000000000000000000000000000000000000000400000000000000000000000000000000000044000000000000000000444444444444444444
44444444444440000000000000600000000000000000000000000000000000000440000000000000000000000000000000044444400000000000000000444444444444444444
44444444444440000000000000000000000000000000000000000000000000000440000000004444444444444444444444444444444444444000044444444444444444444444
44444444444440000000500000000000000000000000000600000000000000000000000000004444000044400000044444444444004444444444444444444444444444444444
44444444444440000000000000000000000000000000500000000000000000000000000000000000000000000000000000000000000000000000040004404404444444444444
44444444444440000000000333333333333000000000000000000000000000000000005000000000000000000000000000000000000000000000000000000000044444444444
44444444444440000500000000000000000000000000000000000000000000000000000000000000000000000000000000000000000005000000000000000000044444444444
44444444444440000000000000000000000000000000000044444000000000000000000000000000000000005000000000000000000000000000000000000000044444444444
44444444444440000000000000000000000000000000004444444444400000000000000000000000000000000000000500000000000000000000000000000000044444444444
44444444444444444400000000000000004444444444444444444444444444444444444444444400000000000000000000000000000000000000000444444444444444444444
44444444444444444444444444444444444444444444444444444444444444444444444444444444444440000000000000000000000044444444444444444444444444444444
44444444444444444444444444444444444444444444444444444444444444444444444444444444444444444444444444444444444444444444444444444444444444444444
44444444444444444444444444444444444444444444444444444444444444444444444444444444444444444444444444444444444444444444444444444444444444444444
44444444444444444444444444444444444444444444444444444444444444444444444444444444444444444444444444444444444444444444444444444444444444444444
44444444444444444444444444444444444444444444444444444444444444444444444444444444444444444444444444444444444444444444444444444444444444444444
44444444444444444444444444444444444444444444444444444444444444444444444444444444444444444444444444444444444444444444444444444444444444444444
44444444444444444444444444444444444444444444444444444444444444444444444444444444444444444444444444444444444444444444444444444444444444444444
