1100000000000000000000
1000000000000000000000
0000000000000000000000
0000000000000000000000
0000000011000000000000
1000000011111000000000
1100000000000000000000
1111000000000000000000
1111100000000000000000
1111111111111110011111
1111111111111100001111
1111111111111100001111
1111111111111100001111
1111111111111111111111